111111111111111111111111111111111111111111111111111111111111111111111111
111100CE0000P100001C1100101001000000CC0C0000000C0000000C0C00000010100001
1C001001C0001000C0100101000000C000100001C0000010001001010100C000100000C1
1000000C101C000C00C1000C00C0000000001C001C00C000C0000000C10C000000C01C01
1000C01C000CC0CC001000001001C000000000011000000000000C000100C00000C00001
1000000000011C0000010000C0C000000010000000010C000010100C0000001000CC0001
10010000CC0000C001100CC0C010001100101C00001000C1000000C1000000000C000001
10110C00000001000000000100000100000C1000110010CC0C01000C0000C00C00CCC001
10000000000CC00CC01000001C00CC000C00000000CC0100000000100000011000C00001
1C00C00000101C0010C101C001010000000000C0000001C1C1C001000110100001000C01
100C0100C0000C10101000C0010C001C00C11CC1000000000C1C0C00000C0C11010C0001
1100C000000000000C0C000010101000C0C00000000C001000010CC0000000C00C000C01
100000C00110C0010010C0100000CCC000010000010000CC0000000000000C011C010C11
100000000C010100C0100C0C0001100100000000CC0C0000CCCCC1000000000000000001
1C01000CC110001010C00011000000101C0C10CC000110000C00000C0000C00000000001
100000C00100C0C00C01010C0C0000000000C0000C00000001100110000C100000001001
1C0000000001001C1001000C0C0000000000C00CC00000CC0000C0100000011011010011
1001000000C0C000100100C1000000C000100000100000010CC000C10CC0000010100001
100C00C0C0001C0C0C0000C00000C00C0000CCC0000000000C00000000000C10C0C001C1
1001CC00C110000C000C0000CC0000000000000000010C010C0100C000C0000010000001
110010000C0C0C000C00000000C00C000001000C00100000000C00000C0000000000C001
1001100101100000100100C0100000C000C00000CC00100C00001000001C0001C0000C01
100000000000001000000C100000000000CC01000100000000C0C00C00C0C00010100001
1CCC000100010000CC0C000101100C01000000000010010100C1010100000000C0010C11
1100000010C00CC0100000000000000000CC001C000CCC000000000C000001C0C0000001
100C1C11010C0000CC011010000010C1C100000000000000000000000000100000010C01
110100000000000001000001000000C1000C00000100001C000100010000000000001001
1C0C1000000110000001CC00C00C000000C10C00000101000C0C00001100000001000001
10001000100CC000000010011CC001000000001C0000C000010001C00000100C00000001
10C000000C000000000C0C010C0C0000C0000C0C0001010010C011000C00000000000001
1C0000000C01000100001C00000C00C00C0010C0010100000000C00000000000000000C1
100C000C0011C000000C0010C000001C0001010000000CC100010C01000000C000100001
101C001C000000000C100000000000C100100100C00C00C001000CC10010C00000110011
10000C00000000C0000C00000C00000000C10C00010000000C100000C000C01110C010C1
1000C0C00001000100C0C00000C000000001001000C001000110000000000C0C10000C01
100001C0C0CCCC1C011000C0C0101C000010C000100000C00C000000001C0CCC000000C1
1000000000C00C000C1C010101000101000010011000CC00100C0C0CCC00000001100001
100000000C0C0000000000000010010C00001101000000000000000C00011000C0000001
11C00C00110000C000000001000001001100C0C00000000000000000C00000100C1C0C01
110100C00100000010000000000100C010000000C10000000000CC00C0000000C00CCCC1
10000C0100000C000C000000001000C00C000000C0000000000000000001001C00C01001
1C10000C000C00CC101C0001010000000000C0000000001C0C0000000C00001000000011
0CC0C0C000000001000000011C00CC000C0110100C000C0C000000C110000000C00CC011
1C000010000000010000C01001100C00001C00000001000100100100000100010C00C1C1
1000000C000000000000100000011C0000C001C000CC0000110000000000100001C00101
1000000000000C000C1000000C01001C00000011110000C00100CCC10C001C010100C001
11C0C00000CC0000000100001000C00C100C0100C00C000011000110CC100001C0100001
11000000000C001000C00000CC0101000000001001000000000010001010000000000C01
101000010000CC00CC01C110C0010C100C00100CC0C000C000C0C0C0C00101C000010001
10000000000000010001010100C000000000C00000CC000100CC00100100000C11000001
10001000C0C00C0001C0010C10101C0000101C01000C000C0010000C00C0000000000001
100000000000C000C00000C0100000100000C10100000000000C1100C000100010000001
111111111111111111111111111111111111111111111111111111111111111111111111
