111111111111111111111111111111111111111111111111111111111111111111111111
10C00E1000001000001000C0C00CPC0C0000100000000C0001C000000C0000000C010101
11C0001C1100000000010C00000100000001000C00100C000001C1000000000010C01001
1C0011000100001C1C000000110100C0C1101000000010C11000000000C1000C00000101
1C0001CC0000C00C0010C1000000C1C0000100000000C01CC0000000000110010C000001
1C000C0C101010000000000CC1C001000000000C0C0000000000C001000C00C100C00011
1001100000000000001CC000001010011C00000000C1010CC100001101C0100C0000C0C1
10001100010C0C000C00C001C000010100000C0001110100C0C0001000C01000CC0C0001
110000C0C10000001000010000C1000000000C00000C001C1C0000001000000000000001
1CC001000000000000C01000C00100001100000C001100010000010001000100000000C1
1000011C000000001CC000C00010001C0C00C00000001001CC00100100000000001C0C01
1010000CC00010C0001000001C0C1000C000011000000000100100C001C0000100000101
101C000C000C000C01C001000100000000000001000C100C1000000CC00000C001000001
100000100000000C000C000C00C0000010010000000C001C00010CC1000000010C000001
1000100000CC100000010CCC00C110000000010000000100001000C1000001C1001001C1
100000000C010000000111000C0C0000C000001000000C001C010000C000100C0C010001
100000C00C1C00C1000000000C000C00000000000001000C00C10000100000C100C01011
11CC0C00C10000000000000000000C100CC0000000000010000000000C00C00010100101
100000C000001000000000000010C00001001001C000C10101000C001010000010C0C011
11000CC01010C1010C00100001001C0100C00001000100C00110010CC0C00000C0100001
11C001C01CC0C000000C000C0100C001CC100000C00C0001C0000010011000CC00000001
1010000C000000000000C010CC01C0000CC00000100000C0100001000000000CCC000001
10CC0C00000000000C0C0000010001C000001C00001100C00001010000000C0010000111
1000C0000C0C00000C01000C000100100000001CCC000100000C0000C000C00000C00001
1000000C000000010000C0000001C01100C0000100C0C000C000010001000000000000C1
100000000100000000100000000010CC01100100C01001C00000C01000011010CC000001
100001C000010000CC000000101001000C0C00001C0000000C01000000C0001000000011
100C100C0000000011C00000100000C000CCC10000000000010C000C0000100000000001
1001000CC00C0010000001000000C000C000000000001000000100C000000C000010C011
100000C0110100000000011000001C000000000100C10010C1001C001CC0100000011011
10C0C001000000000000010001001001C000100100000000C00C00000C00001001011001
10100110000000001C0011C0C00010100C1C10C0C000C001100000C000000000001C1101
100C0000001C00CC00000C0011010C00000000100100100100C00000C0010000000C00C1
100000000000C01000000000C110C00C00CC10010C000000CC1100000000010000C01001
10000C00100C001000011001010C000CC0000011101000001000000010100C0010100001
10000000000000000000C0001000011100001000C00000010C00C0C0100000001010C001
10C010C00CC000000CC0000000000C00C0000000CC00000000CC01000000010100110001
1000C0000CCC101010000010010100010C00000100100C00111C0010C00010010000C001
11001000C0100000001001001011100C00C00100CC1C0C10001100101000000000000001
1100001000100000C1C00000C0CC00001000010000C0C00C0C000000CC000100C00CC0C1
1110010000C00000010C0C00010010000011100000010011C0000001C001100000000111
100000C0000100001000C01010C1C0000000000C010000C100000000000C11000C000011
100001C0CC011001C01C000C0CC0000C00000000000C00000000000C010000C110C01001
10110001010000100C010010000001000C0C11C000C000CC0C01001001C001001C000101
1000010000C00000C00000000C000000010100C00000CC1000C00100000C00001C000C11
10010C010000010C0CC0C00010010C000C00000C00C000C0000000000100000C0C00C001
1000000010C000C0000000100001C1C1CC00CC001101000CCC010000C110000001000001
10010C00C1C100C0010C10000000C0C00000C100001000C0000000000C10001011100CC1
1000CC00000000C0CC10C1C1C00010000C01100010C00101C00000000000C00000101CC1
1CC1000C001100000000C00C10C000CC0001000C00C00000000C0C000000000C000C0001
10000C00C00000000101C000C101CC000010010011000000000C000010C0000CC0001101
1C0000001100110000C0000000C0C0C0C100100000010000C010010001C110110010C0C1
100110001000000001C0C010CC00001000010110011C00000C000C0100000C0C11001011
1C0000000010C0C00000001C10001100C01100C00000010000010000C00010000001C011
100C0C00000010C001CC000110C0010C010000000000000C00C00CC0000000C01C000001
10C0001000000C0000C0010000000000C0100C00C0C0C000010000C000C0CCC000000001
10000100C010000010100C01C010100000C000C0C010000001000000010101000001C001
1100010000000000000010001100C00C100000C10C0000000C1111110000000000001101
100010000000010C000000000000C0C000100000C10C1C0000011C0C0010CCC001000001
10C10C100001C0C100C11000110CC000100000000001C1C000C0C00000000C0000000011
10000000C000010000000000100100C0100C0000000000C00000000C000C001C000010C1
10000010000100001010C00C000100C1000CCC100C0000000CC000010100000000100001
100000000000000000000C00000C0000C0000C1100100000000010C0C000001C00000001
110CC00000000C1100001001000C10C011011100000CCC00001100001000000000000111
1001C1000010100001C000000C00100000000000C100C001000001000000001C0C010C11
100000C001010001100C10000011000000001000000C00C00001100C01C0C00000000001
1C000C001CC100010C0000C00CCC001000C100000C000000001001001100C11000C00101
100C0010001C00000C000001001010001000C0000000000C01010000001C0010100C0111
1C1000C1C01000000010000C0010C010000C00000C0000C001C100000000101100000111
100C11000100CC00C1100C00000C00100001101100001111010C0000000001000000C011
100000C0100000CC000C000C00000001010C10000C0C0000C000001001000C0001000011
100C000010C000CC0CC000C10000C00000000C0001C00C00000C0000000C000000000001
1000CC000C001010010CC0C1010C000C0000100010C0C0101000C1000000000C01000101
10C110000000000CC00C100001000000100C010C010000C101101000C0001C0000CC1111
10C11C000010011C0011100000001100000000C00C000010C0010CC00C00000000000001
1000011CC000010C0C1000010000100C01000010100C0C01000001000010C000000C0C01
110C00000C1C0000C1001C001CC00001010C1010C000000CC0C000C100000C0C0000C1C1
1C000000001000010000C10CC00C0C0000100000011C00C00C01000000C000C00000C011
1000000000CC000C000C000C0000100000C011010000000000101C00C000010100010001
1000CC0C000100000C001C010000000010000000010000C000C01C00011C000110011C01
10001100101C1100010C01100000000C010000CC0100C00010C0C00C00000000000000C1
11010C0000C0000000000C0000000010C000C000CC00100010C00000010000C000000001
111111111111111111111111111111111111111111111111111111111111111111111111
