11111111111111111111111111111111111111111111111111111111111111111111111111
1E0000P10010010000000C00000CC110C010100001100CC000C1000C001000000001010001
1C00100C0CC000CC000001001000010C000C01C0000CC100CCC010CC100C0000000C000011
1110010CC000000C0000000010000100100000C0100C100C00000100C100000C0000C00001
110C00100001C000C0CC00C00C110001000000C001100000000010000100C0000110000001
1000CCC0C10C0C000000100001C00000010000000001C010000000001000000000C00001C1
100010000C0C0010010000001C0C00CC000C000C0000000000001010001000C000CCC00011
1C0000000000000000C0000C1000000000100C0000010000C01C00C010C1C0C01CC0100011
100000001C000000000000C001C10010C0001000C00CC0CC001000000C10000C00C10C0001
1011CC0010001000100000C00101C00000C10010CC010C0000010000C0000000C1000C0001
10C000000000000C0010C011000C00C0C0C000C0C0C01000000101C0000010C01101C00011
1000C00110C000011100C01010C0000C000C0011010000100000010010000010001000C001
1000010000C0C00010C0000000C001000010000C0C0000010C0100C00000000C0000100101
10C00001001001010CCC00CC00000C1000010101CCCC00001000C00000CC00C000000110C1
10000C00101100C001C00C00CCC0C0001100000001001CC00000C11000001000000C000001
10001100000CC0000001CC0C000CC1000C001100000101000C01CC0010C0001000000C0001
10000000000011C10001100000C000CC1010C00C000000C0100C00000000101C0C00000001
10001C0CCC000C0000000000000000000C0001C0C1CCC0000000C0001000110111C0000001
10001000000000000000C0001000C0010001C00011C00000001011CC1C01C000C000C00001
1000C00C00010001C1000101101C00100000110000000100001010000000000001000C1001
100000000001000000100100C0000101C00CCC1011000C000000C000010000101000000001
10C0000000C0100101000000001CC000010000100C00000000000C01000C00001C00C00001
100000000000001000000000C010000C1001CC0000C00000C000001000000101C0010000C1
10010000C1000C000000C110000000C0100000100C1100000C011000C0000C000CCC0C0001
10000100C000C100C00C01C00100000000100C10C0C000010100000C00100CC000011C00C1
10000000001C001110000001000100000110000010C000C0C00000C000000C001000000011
1CC00C10CCC011001100CC100001100010000C000000001C0C00100000000010CCC00001C1
1010011100001000000CC10000C0001011000C10C0C00C00C00CCC010C0000000000000CC1
1000C0000011000C010000100010110000000C101000C0000C000000C01C000C0000001011
1000C100C011C0C00101001100100C0C00001000C0C10000C10000000CC0000000CC00C001
1011100001000C00CC0C0C0C00000100000C00100C0C0010000010C000000000000C110C01
110110000000100100010C000000010000000C0101C0000000000000C00010000010CC0101
1C00001C000010001010000000001100000010C0C10001000C0CC0C0000C01C000C0000011
1010000000000001000CC00C000C00C01001CC00000001000000000000C1C0000001000001
1000CCC00000010C0000000000001C000C0001000C1C0C0C00100000C000C0010010010001
100011C000000C000C0C011C0C100C10010C00100000CC000000001000C00CC00000001001
11111111111111111111111111111111111111111111111111111111111111111111111111
