1111111111111111111111111111111111111111111111111111111
11000100001000E1P0C00000C01010C000000000000100001100001
1C1000000C00001C00000000000C000C0CCC000100000C000C000C1
10011C0C01C1000001000000CC00000010100C0000000CCC000C001
100100000000000C0C0000000C1C000010011001000000C0000CC01
100000010000000C01000000000C0101110110001000C01001000C1
101C00000000000100100C00C0C00001000C1000000000001000001
10C00100000000C0C0C01C0C00000000C010C000C00001010000001
100000001C00000000101000000100000000001001001C11000C001
100C00000000100C000C000000000C000001000000000000C000001
1111111111111111111111111111111111111111111111111111111
