111111111111111111111111111111111111111111111111111111111111111111111111111111
101000100001000E1P0C00000C01010C00000000000010000110000C1000000C00001C00000001
10000C000C0CCC000100000C000C000C0011C0C01C1000001000000CC00000010100C0000000C1
1CC000C0000100000000000C0C0000000C1C000010011001000000C0000CC000000010000000C1
101000000000C0101110110001000C01001000C01C00000000000100100C00C0C00001000C1001
10000000001000000C00100000000C0C0C01C0C00000000C010C000C0000101000000000000011
1C00000000101000000100000000001001001C11000C0000C00000000100C000C000000000C001
10001000000000000C00000011000C0CC0C000C00C010001000CC000000C0000000000000CC001
100C0001000C01C0100C000000C00000100C01C0000000C110000011000000C100010000101001
10C00C0001000C000C000100000000000001001000000C001C1000000100001C0C01000CC00001
111000000C0000C0001100C00000000C000100C00000001C0001C1010000C0001C00000C1000C1
10CC1000010000010000C00C00110110000C10000C110C0000C00C11000000C01C100100000001
100C0000100C0C0100010010C01C00100000C00000000000000000C0C000000010C00000C00001
10000CCC1011010C010110C11000000001C0010010C0001C0C000C000000000C1001000C000001
1001000010CC001C0000000CC000C00C000C00000001C001C0010C001C00010000011000101001
11C0000000000C001000C010000000010011100CC000C0000C01000C0000C00C000C0100001001
1110000C00CC0C000C0C000000000010100000000001C000110000000C00C00C00C0000000C001
10000001010000C00C000000100010C01010C00101CCC00C0C00001C110001C0CC0100000000C1
10C0101C1000001000001C1C10000000100000C001C00000000CC0000C001000C1C00000000001
1000C0000C000C000000010CC1C000C00000C00C011000100000001000000010110C00C0C00001
10000C0C0000100C100C0000C000001000C0100100C0000C000100CC01001000000C1000110101
10000C00C0000C0000C01110C00C00000000CC0C000000000C0C0CC100110000000C0000000001
100C00001000C010001C001000101CC0C00000C0110000000C01000C0000C00001100C00000C11
1000010000000010000C0000000000000100000000000010100100C0000C0100010010100010C1
1000C0000000000C01C0000C0010000C0001101CC0000000000100000000000001001000001001
1100000000001C0C00000000000000C0100C0000000000000CC000011CC0C0CC1C010000C00001
10C0000000C10100110000000000000000010000C0000000C00010C110001C0100100110100C01
1000000000C00000CC00000000C00000000010C000C0000000000C000000000C10000C000C0001
101000C00110100100000001C000C010000000C0C00000000000001010100000000001C0000C01
100101001000C00001000000C000010C000100000C001000001000000000001CC0000000000001
1001C00C000101C000C001CC0C0000000100001C01000000C0000C000001000001000000100C01
11C00C1001010000010C0000000C01C000C010C000C0000C100000010000CC00000000C1000001
1000000C0000C000000C1000000110010C01C001C0011000000C00000000001000000100000011
100000000010000101C1000000010C0101C000000000001001000000010C0C0001000000000001
1000000101000000C00C0C00001CC00000000C0000000C0CC0000100000000010000000C000001
1C10101000011C00C0100000000000000C00010100000C000001110C0C01000000C01000C00101
1001001000001000C0C000C10000C0000100001100C000100C0000C000000C0000100C00000001
1000010C0C000010CC00000000C01000010CC00010000CC1000000000000001001011000100CC1
1000C00C11000C000000C00C0C0000C1000C00100C0C0000C0C00000000000CC00C0C000000101
100C00000C0000100000C00000000010C1C000010110C00000CC000000C1000000000C0C000C01
100000C0000C000C0001100C01C0CC000C000C000000000000000C0C0010000000C100100000C1
10000C000000C0110100C0C00000000001000100000000000010100000C0000001100000010C01
101010001C0C0010000C0C0C01CC10000000000000010010CC001000000100C000000000000CC1
10C00C00CC000100000CC010C0100000C0000C000100C000001C00000100CC00C01CC00CC11001
10C0C10C00C0100C00100001000CC01001000100000000000000000C00C010C10000001CC00001
10C0010000000010000C0100011010C100C0000000C0CCC00C0000C0000C00000100000010C001
10C0C000000CC0000100011000001100010000000010000000CCC0C001000100000C1000000001
10C1000000C0C00000C000000000000C000C1C0001CC0000100C000011C01000001000C10000C1
10000C0000C00000000010C00000C0C000C0C11C000001010C0CC000000C1011010C00C0011001
101010C00CC000000001CC00C00000000000C0000C00C00000C01010000000100C001000000001
1C00CC01000000000000010010000001C00C000100C001000C000100C0010C0010100001C0C001
111111111111111111111111111111111111111111111111111111111111111111111111111111
