111111111111111111111111111111111111111111111111111111111
10P0000E0010C00000101000C0001010000C000100000001000000101
10110100C0000000101000000C0001000010CC00C1C0100C000C00001
10010C0000000100000C100011000C00000100000000C0000C0010011
110010100010000C0C0000101000C00000C0000CC0001010010C00011
100000000111000000C0100C1000000000C1000C0C000000010010001
1001000000C0100C00000000C0000000C000000C00001C00C00C00001
111001001000000000C00010000C00C00001000C00C00000000000001
100010000000010100000C10C000000000C000000CC000C0000C01001
10000000C00000CC0001C100000000000000001C00000000100000001
10000010000000000001000000000000C00001000000000C11C0010C1
1010010010010C00C0010001000C00001000C0000CC0CC0CC00000001
10000000001000010000000CC000100C1C000000C0000C00C00000C01
1000000C00101000000001000C10000000000000000000000000C0001
1100000000010000000000010010C000100000100001000000CC0CC01
100000101C0000011110C0C1110000C010101C001001C000100110011
1000C10011001100000001000111C00000000C0000100C000C0000111
10000001CCC100000C111C00C0CC000110C0CC000010000C0C1C00C01
1010000C1CC01001000100001000C00001000000CC000C00C10100011
1C0C00C0000000100C00C01100000000CC10000000010000001000001
10000001000000000C0000010011C00000C00010000C0C000110C00C1
1CC000000000100000000C000101000C100C000010C10C01010C10C01
11C000C0C00CC01000000CC001000000000000C00C000C0C010000C11
100010C0000000100011C0C00000000010000001010CC1C0CCC000C01
10100100100000100C0C0010000C00C000C1011C000C0000CC0000001
10000C000000C00C1C0001000010000C0001001110010C00100000001
100000101000C0000000000C01000001010C000C00100000000C0C011
100001000000100000111000C00000C001C00C01C00C101000100C001
100C000001100000CCC0C1000C000C000C000C0C00000000000001C01
1001C00001C000000001001C000C00001001000010000001000000001
110C00101010010C00C00000C1000C001000010CC000100010C001001
10010110000001000000CC0010000100000C01C0C0C00000000011001
1C01C0000000C110100010C100000000CCC000C00C0000000C1C00001
1011C0000C00C00101C00C0C001000000000000000001000C0C011101
10000001C00100100001000C0000C001C0000C10C000100C100010101
11001C10C1C0010000000010C00000000010000000000C00100C00001
10001000000C010000000CC1CC0C0111000C00000CC1100000C001C01
10C1000C0000000C010000001CC000C00000C000C00C0000000000001
1000C001001000000000CCC0C100010000001001C0000000000000101
100C00C0C000001C00001C10C01CC00000C00C00000C0C0C00000C001
1010001010C10C0000C10001000C000000C0C0000000CC01000000001
111111111111111111111111111111111111111111111111111111111
