11111111111111111111111111
11PEC00010000C00C00000C101
1CCC011C001010000001000011
1000C0C0000000000100000011
100000C000000000C000000001
10000000100000000000000001
1C01010C0000000CC00000C001
111000CC0C000000000C001001
110010010100C00C1001000001
1001CC100010C00C0100011C01
1C0000C00000001C0000C00001
1000000000CC001C00CC000001
10010000001000000000000001
100011001000C0110100100001
1C0010000CC000000010000C01
1000C0100C000C01000000C0C1
10001C01000C00CC0C0C100001
101000C0000100010C000000C1
1010C00C100010C00000C11001
1000C000000010C00C00000101
1110000C0001C0000000010CC1
10100C01000000000000011001
11010C000011C00C01C11000C1
1C000000000CCC0000C1111101
10010101C00010000000000001
10000C00C0000000C0000C1101
100001000100001000100011C1
1000C0000010010110C00C0001
100CC00000000000000C0C00C1
10C0000000C000010000110011
1000C110C0100000C010100001
1110CC00100010C000C0011101
1C1010C1110000C00010000001
10100C00000000001100001001
1000010110100C100000C00101
100111000C0C010000C1010001
10010011010CC00010C0C00011
10C01010C00000C00001000001
10000110C01C00000010C00001
1C0C0001001100100000000001
10000C01CC0100000100000001
100C000000010C00C010000001
10C0000C00C0000C00000000C1
10C0000000C0CC000010010001
10010000100000000001011001
10110C010C00C0C00C0CC00001
10010000000001010100001011
100C00C0000C00000000000001
100000C0001000110C00000001
10011CC11100000C000001C011
110C0000C100000000100C00C1
1000000000C00000000C011101
1C0C0000CC0C11000000010101
11C0000C001000000010C00101
11100C10C000000010101CC001
1C1000C000C010C0C000000101
1000011000C0C0C0000C10C001
1010010C00000000001C000101
1000010100C100000000000101
11001C00001000C0CC00C0C001
1000000C000C000C1100000001
11001010000000000010000001
10C010C0C0C11000001C010001
1000010010C011C010C0000001
10CC0CC1000110000CC000C001
10C10100000000100000100111
10C1CCC0C0CCC0C00000001011
10001000C0100C100000100001
1000000010C0CC011100000001
11111111111111111111111111
