1111111111111111111111111111111111111111111111111111111111
1EP00010C00010C0000000CCC000001100C0C00000C0110000000C0101
10000C000001C00010000C10000000010010000000001C101010C00001
10001100C00000100010000C00C001C0000010C00C0100000000C0C001
10C0000C100001100000C00000C0C1C000C0000C0000110C0C00100001
1101C0C1001001000100C0C1C00CC0000C1C00CC0C00100110000010C1
10C010011100C0000011100000000000C101010001000C0010100C0001
1C000000000000001C10001C10000000000000110000000CC000000C01
1000C01001101000C00C10CC0C0100000000000C01C000100001011001
11C00010C00C0001C000CC0C0100C00010100001000001000000000011
110C0CC0000C00C0010000C00000C0001000010000000CC00C00000001
10000C00001000C00100000000CC00CC001000001010C0000001001001
100C10000000000000C0011C0000CC0010000010010C0000000C001011
1000C0001000000000CC00C0C00C0001C001C101110000C10C1000C101
1C000100001C0100C00C0001000C00000101000C000C0CC00001000101
100C000000000C0000000C10010011001000000011001001000C010001
10000C01C0C1C100000000011C00CC0000000001001C0C01100C100001
10010CC0000000010C000000C0C000000C001000C1C0CC0010000110C1
10C00000CC0000010000CC0C00010C0001001C0010010C000010C00001
10010C01000C0C00C000C0101C00C0010001C000CC0010C001C000C0C1
100C00000000CC00100101110100000C0C01000000000C00C0C0011001
10000C0000000001C0000001000000010CC0001C001000010C00C00001
11100000000100010C0000000100000001000C00CC01C0C00000000001
1001000C0000CC10CC0000010C0000000000001000000000000C00C011
11000000C010000C000000000000C0000000101000000C000000C1C001
100C0C0000C100001C000010001000100010010000010000C000000001
1000000C000C00100010C0000100000000001C001000100001000C10C1
100000C001001C0CC0001C0C01000100100000C000100C01C000010001
100C010010C100001011C0010C0C00CC0100C100C0100000C00C011101
101010C000000100000CC00C000000C000C0CC000C000C100000000001
1000C000C101C1C100010001000000000C1C00010C01C0010000110011
1000111000C001000010C0C000001C0C0001000C00100C0010C100C1C1
10000000C0010CCC00100000000CCC0000000000000000000C0CC00C01
100000000010010010C00001000000CC00C0001C01C00C000000100001
1000001100C0C10C000001C01C000000000C0C01000000000101100001
11000001C1C101000C000000C0000CC1C0C1011C00000010000C010101
100C0011000001100C1000C100000001100C00C000C011010C00C0C0C1
1000000C1000000C0C0000100C01111001000000110001C000C000C001
1C000C0001001000C0000C00C010100000000000000C00000101000001
10000000C00C0100000000110000000000000000000000C011000C0001
1000001000000C000000000100000001001000CC000000000000000001
1000101011000000000C00C0000000000C000C00000000000001100001
1001000000C0010000100000000001CC1100001C00000C000000C00001
11000C00C011000C000000C00CC00000C101100CCC0000010CC1C00101
10000000000000C000010C01C1100C00100110000C001000C000000C01
1111111111111111111111111111111111111111111111111111111111
