11111111111111111111111111111111111111111111111111111111111111111111111111111
10C0C000C00CE11CP001C10000010000000C0C100C000000C0C10CC00000100001C00010C0001
11010011101100C000000000CC100CC01100000100000010000000C000C11000C00000000C0C1
1101000100000000000100110000C01C0000010C101C010000C00010C110000000001001C0001
1011000C00C000C000000C0CC1100001100000101C0010000CC0C0000000000CC0100C0000C01
1001000000000000100C0001001010CC0C0000C000010000C00C010110000000000C111000C01
100C010010010001C0010C0000C00CC1000CC100010000000000C0000C000000000000C101001
1000000C00001001001C01000C0C01010000000010100010000CC00000100C000001000C00001
10000001000C10C000C01C0000000C0CC0C0011000000000000000C0000C00CCC00C110000001
100C0C100CCC0C000C0000110C000CC00CC0001000000001000C1C00C11001C00001000C00001
1CC00C00010000C0000000001000C00000C1C1C10100000000CC0C0101001000C1101C1000001
101010000000000000001100C00000C0010C0C000010010C00000000CC101110C000C0000C001
1100100C01010000000000000100000000C000000000000000C0000C001001C0C00000000C0C1
10000C00000CC00000001C10C0C000C100C000C0000C000C10C00010010C00C1000000000C001
100000000C000000100C0100C00010010C0000000010000000CC01C000001000000CC000CC001
10100C0000101000010000101C000000CC00001000C100C000000100000000100000C000C0001
10010C00C00000000000C00000C000000010010001001000010000001000100C0000000011101
10C00001C1100011000001001CC0010C0C01C001000000000000C0C100010C01100C0100CC011
11C00001000C0000CC010000C00000100C0C0000C000001001000000001C1000010000C000001
10001001000C00000000000000C0C0000C1C01100001000C000100000010010000C0000010001
101000000000C000000C0C0001C0000000CC000CC11000000011C0010010C00C0000001000001
1C0000C0000000010010000001110010C0101000C000000C00000000C00C000000000C0C000C1
1000000CCC0000000101C1000000000C01000000C0000000C01100C0100000010110000110001
100100C1C0101010000C10000000100000000001CC000C00000000000000000C1000000C00101
10000C0011100C0000001000C00000CCC0C000C0000CC10000001C001C00000C0CC00C0001001
100000C00000000000000C00C01CC0100110000010001000000CC000010100001010CC1001011
11000000000000C0C10110001CC01000000C000100C00000C00001011CC00100C01C0C0110001
10000000C01C001000C0000001110100000C000001000001000C000000010CC00C0C0C0C10001
10000C1C000C1C00000000010011CCC1C0C00000CC00CC10001C000100CC0000000CC0C001101
10001000C0C10000C00000100C010C0000100000000000C1001CC0CC0101C000100C00C000001
100000010000000100C0C01010010010C100C0C01100100000000101C00000010000000101101
10C000C11000000C10000100C010000C00100010100100C0000C01000100C0000C00000010001
10110C1000000100010C000000000100000000000000C0000000000CC00100000C010C0000001
1000CC100001C1C000011000C00001C0CC011C10000000CC00000C000010000CC0C0000000001
10000001C00000011C10C00C100000000C000C1000C01000100001010000C000C000101000001
101000C0000100CC0110C00101000001000010000CCCCC00001C000000110000000011C0000C1
1010001001100C000001000110010100010000000000000100CCC10C000000000000C000110C1
10000000010C0010000100000C0010000C0001000C00000000000000000C01110010000000001
11C0C0010C0000000C00C10C0000000010100C000000010C1C101000000000100001110C1C001
1000C0C0001C0C0000C001000C101C10110000000000C1010000000000000000010000000C101
100C0000C00100C0C000C0C0C00000000000100000000C000100000C0000C001C000000000011
1110C0000CC00C00000000C01C000101001000100000010C00C0C11010C010010001000000011
1001000CC10001C00010C11C10C0110000C0001000C001010000C101100000000100100000111
10001C00000C0CC0C0011101000000C00000C1C0C00000C1CC100100000000001000001000011
100010000010000000C00C0C10101000C01100110000000C1000100000C01C0000000000000C1
10010010000C000C000000C1000C0C0000C000000C0000C10100100000C00000000000000CC01
11000101100C01C00110C000000001C00100C0100C0001C110CC00000101000000000000C0001
1C00000CC00C00001001C01C01110000000C00000000001C1000101100C01C001000CC1000101
10000C000000000010101000100000C0000011100C10000C0000000001C01C1011010C00CC001
1C001000000C0C0011CC1C1000C0000010001000000000C0C011000010C00000CC000C1CC0101
100000000000011C0100000000010000C00000110100C01000100000100111C0010001001C011
10000100010C100100100000CC01000011000000000000C10001000010000000C0000101C0C01
10C00C0100001C000C00000C0001100C0CC0C1000000C00100000C0010011CC0000C000C0C001
1010000001C0000000100000000001C000000CC0011000000010010C0000000CC000CC0C00001
1C000000CCC00100C01001001C01101010C00C10100C11000000100C0000C000000010C000001
10010010000010000C001100000C0000C000C101C001C0CC11010110000000000001C00100101
1C00001000C000101C01C01010CCC0011101C00000000000000000C0001000001000100000C01
1000010000000110000C000000C0000C00000C10000100CC00110C1000C1010101C00C0000001
10000000000C000000C0000000000C000110001001010010C000001000010C100000001010001
11000C0100111000010C0000000001C010C00CCC0000000C01C0C0100C000010C000000000101
10C0000C00010CC000C1C0000010101111100000000C00C000C1C0000C100000C000CC0001001
1010000C0010000000C0C000000C0000001000001010C000000C00C00C000010000010000CC11
1001C000000010000110C1001000C111000000C0100C00000000000C00000000010CC00000111
10C0000010CC00000000000000000000000010101000000010010C000000000001C100000CC01
101110C10110101000000C100C0001000C100C101010100000000000000010C00000001001001
101100C0000CC0C00000C01C00011000000C0100010000000CC0C00000C0C0000000010011101
1000110000C1000000000100C000CC110100C001001C00100C00010000000C000001000001C11
1CC0C0010010010111C001000000C1000000001C001000010000000100C00C001000000C00001
10C01010001000000000C010C1010000000CC1001C000CC0100100000000000C000C000000001
10100000000C0000C01C0C000000010000001000C000000001000010C1010000C101C00000001
1000C00000000000C00CC0011000C00C001CC0000000C001100C00C10CCC00000C00000000011
1000001000C00C0001000110100000C0CC00000110000000C00001010000001000100010C0001
10100110CC00001000C000100000C0110C0010000000C01000C010010C000C0000C01C00C10C1
1000001C001C0110000100000C10CCCC00C00001CC011101000000000001C0C0C000000000001
10C00010C0C00C0000000001C0001000000CC0010000CC001000000000000000000C000000101
10000C00C0CCC000C00CC000C00100001000100100000000000001010000000001100000010C1
1100C1010010010000000000001000001CC0000000010C0C1000000100100001C011000C00001
11111111111111111111111111111111111111111111111111111111111111111111111111111
