11111111111111111111
10P00E0C1010C01000C1
11100010C00001000001
1000001100C000000001
1010000CC0C100100C01
1CC01001000000C00CC1
10100C000C0000000101
11111111111111111111
