11111111111111111
10100010CC00CE011
1C10010101000PC01
1C0C000CCC0000001
10100000000000011
11111111111111111
