111111111111111111111
10EP011C0000000000001
1100C000C00000C000011
10001000010001C0C0011
1C0001C0C01000C0C0001
111000000C0000C101001
1CC1CC010C000000C0001
10C0000C1C10101CC0C01
100000010C10000000001
1000101000000110CC0C1
100CC0C00001010CC00C1
1CCC010000000C0001C01
111111111111111111111
