111111111111111111111
10E0C000001000000C001
10P0000100C000100C001
100100100000000010001
10000000110C1000C0C01
1000C000CCC0000000101
111111111111111111111
