11111111111111
1000C001CCP001
100E000CC0C011
10000000C0C001
11111111111111
