11111111111111111111
100PE001000C00000CC1
100C00CC00000C010001
10C00C10C000000C0001
11111111111111111111
