1111111111111111111
10011011P00010C00E1
10000C0100000000011
10C10100C010010C001
100C0100000C1010001
10000C0000100000C11
1C000000010000C0001
100C1C0000100C01C01
100C00000000000C0C1
100000000100C000001
100C000C00C00000001
1111111111111111111
