111111111111111111111
10000CEP0000000000011
1CC00C000CC1000010101
1000010C000CC0C000011
1000C1CCC00000C000001
101000000010001010001
1000010000000000C10C1
1C0000000C000000000C1
1CCC00000CC0000000001
101C0C0C00010C0C01001
10000C001001000000001
1CC0000C00C0CC0C0C0C1
1000010C001001C000001
110C000100000C00C00C1
111111111111111111111
