1111111111111111111111
10P0000E00000000100001
1000C0C000C000C0010001
10000010CCC000100010C1
11000CC000C0C0C0100001
100000010000C0C01000C1
10000000C0C00010C00001
1100010001000CC1010001
10001C000011000000C001
1111111111111111111111
