111111111111
10PE00000001
10C00C100011
1C0000100CC1
111111111111
