1111111111111
10000P00E0001
10100C0000101
1CC1000001101
1010000000001
1111111111111
