11111111111
10000C1C001
1E0000P00C1
1000100C0C1
10C0C000CC1
1C1110C0C01
100000000C1
100C0001001
11111111111
