1111111111111
101C000E11001
1P0CC00000001
1C00000000C01
110C010000001
1001010100011
1101010C01101
10000C0000001
1000000001001
1C00000000001
10000000000C1
1000010100C01
100C010000001
1111111111111
