111111111111
1001P000CC01
1E01000C0001
10CC0100C0C1
1010010C1001
10011C0C0001
110000000001
100000000001
100000000111
1100C0C11001
10000C101001
100000C10001
10100C100101
100000C00001
111111111111
