1111111111
100C1E0011
11P00C0001
1001000001
1000010001
1100C00CC1
10C1000001
1001CC0001
1101000001
10C1C00001
10100011C1
10C0C00011
1111111111
