111111111111111111111111
10CPE010000000C00001CC01
1C1100C000000C0000000001
1C0CC0C1CC000000C001CC01
111111111111111111111111
