1111111111111111
100EP00000000001
10CC1000000C1001
1000100100001C01
10001000C00010C1
10C0000000C01001
10000000C01C0001
10C0010C01001001
101100100C011001
100C100000000011
1C00010C010CCC01
1C000C0000000001
1111111111111111
