1111111111111
100ECC00P0001
101C110010001
10010000C00C1
1100000CC00C1
1000000000101
10CC0100C0111
1100C0C000001
1000100100111
1C01000C00001
100C000010101
10000000C1101
1111111111111
