11111111
10P10001
1E001101
1100C001
1C010C01
10010001
11111111
