11111111111111111111111111111111111111111111111111111111111111111111111111111111111111111111111
11EC0PC0000100001C10CC000000000000000C0001000000C1000000000000000000000C0C000C00C0000000000C001
1000000000C00C010000000CC010000000000100C0010C00000001000C00C00000C00000000C1000010C00000000001
11C0C0000C0C01100C00C000CC0110C001000000000C00000CC10010000C1100C000C100C0C001010000000CC00C001
11111111111111111111111111111111111111111111111111111111111111111111111111111111111111111111111
