11111111111
1CE0C001011
1100C111001
100C00C1001
1C00C0PC101
11110000001
10CC1100001
10101000001
10C00000001
10100000001
10000010001
1000C000C11
10C00C0C101
10000000001
100000010C1
1000100C001
100000C0001
1001001C001
1C0CC00CC01
1101100C0C1
10000100C01
10100010001
11100100001
10C0C000001
10100000001
100C000C1C1
10C00000001
1000101C001
1C001CC0C01
10100000001
1000001C0C1
101C000C001
100C100C001
100C1001001
100000C0001
100000C0001
10000110001
10000000001
1100000C001
1C010001001
100C0000001
1C000000001
10100000C01
100C01100C1
100110C0001
10001C10001
100000000C1
100001C0001
10C010011C1
10000C01001
1011C100001
10000000011
1000C000001
110010001C1
1010C111C01
1001C000001
10000001C01
111C0010C01
100000C01C1
1000C000101
100C0C000C1
10010001001
100000000C1
100000C0001
10000000011
10C10000C01
10100000001
1000C101C01
100000000C1
10C00C11001
1CC00C00001
10001000001
100C0010001
1000CC000C1
10000000001
1C000C10C01
10100100001
11C00001101
11100000011
1C000C00101
100C0C1C001
10100010001
1100000C001
100010000C1
10C00110CC1
10000010C01
1C0000C0001
10001011011
1C000100001
11111111111
