1111111111111111111111111111111111111
10001000000000000C0000000000000100001
100P100000000000C1C0000000000001E0001
1111000000000000C1C000000000000011101
1000000000000000C1C000000000000000001
10CCCCCCCCCCCCCCC1CCCCCCCCCCCCCCCCC01
1C111111111111111111111111111111111C1
10CCCCCCCCCCCCCCC1CCCCCCCCCCCCCCCCC01
1000000000000000C1C000000000000000001
1000000000000000C1C000000000000000001
1000000000000000C1C000000000000000001
1000000000000000C1C000000000000000001
10000000000000000C0000000000000000001
1111111111111111111111111111111111111
