1111111111111111111111111111111111111
10000000000000000C0000000000000000001
100P000000000000C1C0000000000000E0001
1000000000000000C1C000000000000000001
1000000000000000C1C000000000000000001
10CCCCCCCCCCCCCCC1CCCCCCCCCCCCCCCCC01
1C111111111111111111111111111111111C1
10CCCCCCCCCCCCCCC1CCCCCCCCCCCCCCCCC01
1000000000000000C1C000000000000000001
1000000000000000C1C000000000000000001
1000000000000000C1C000000000000000001
10P0000000000000C1C000000000000000001
10000000000000000C0000000000000000001
1111111111111111111111111111111111111
