1111111111111111111111111
100000000000C000000000001
100P0000000C1C00E00000001
10000000000C1C00000000001
10000000000C1C00000000001
10CCCCCCCCCC1CCCCCCCCCC01
1C111111111111111111111C1
10CCCCCCCCCC1CCCCCCCCCC01
10000000000C1C00000000001
10000000000C1C00000000001
10000000000C1C00000000001
10000000000C1C00000000001
100000000000C000000000001
1111111111111111111111111
