1111111111111
10P10E00CC111
1000000001001
10101001C0101
100CC00000001
10C0000000001
1011000000001
100C001000101
1000C001000C1
1111111111111
