11111111111111111111
10P00000CCE0010000C1
10000000001000000001
10C00CC0C10000011001
100000C0010C10000001
10010CC00110000C0C11
100C0100000000000001
100C0010000000C00001
1C01C0C0C000C010C001
10000000001000010C01
1001C0CCCC0100010101
100000000100C01C1CC1
1C000C0C0C11000001C1
11111111111111111111
