111111111
100C00001
1P000C001
100C000E1
111111111