11111111111111111111111111111111111111111111111111111111111111111111
101E00P0000C0000010000101000000010000100CC0C00000100C0011C01C0000011
1C01C0C0000000000C00000001C01C00C0C0000C01001001C1101C11C100C0C0CC01
100010CC01000001010000000C0C110000010C0C0C1C0000C0CC11000C011C0000C1
1000C00010000001C00000001000C00000000C0000C01100000000C00C00000000C1
100101000010C0000010C00100110101CC0C100C0C1C000C000100C0C010C00C1101
10100000000010000001000110000000C000000C10CC000110C100000C000C000011
100011001C00000C0C010000000000CC000100001CC00C0C000C0000C0000C001001
10000C000100000C00CC00010C0000CC1CC10000000C000010101000CC0000001001
10000000C0C100C0C1C10000000000C0000C0001000000101000000101C010110001
1C01000000C0C010100001000CCC000110C110011000010C0000000C0C1C010000C1
10C010C0000C0000000010C1111C000CC0C0010C0000000000000CCC0010000000C1
10000C00000CC000000010C000C0C000000C101CC10110C0100CC000000010011101
100000C000000C0001010C00CC0000C000C0010001000000C00100010C000C010001
10100011000000001C00C1010000C1C00001000010C0010000010000C0CC00000101
1000000001000C010C100000CC000100000000000C000000000100010000CC000C01
1100C100C0000100C000000C0010C000000010C110000000000000C00010000000C1
100000000000000001C00C1100010CC0C0100100000000111000000010000C000101
10010000C0000010000000000000000000000000010000000100000000C0C0100011
10C0100C00100100001000010000C00CC0C00101CC10101000000000001000000101
1C00100000010011000010000C001010CCC01000C000100000C000110001100C0101
10000C0000001000CCC0CC0C10C00000100000010C01000010001000000000C00C01
1C100100000001C1000C0C00C0C00001000C0000010010C1000000CCC000CC000001
1000100100C000001010C011C1C00001100C000100010000C00C0000100000000001
100101C0C0001000C000C00C1001000C0CCC0001000000CC00001C0010100000C0C1
10100C1C00CC000110000C00110C011000001C01C0C0C000C010000000000000C001
10C0CC00000C1C0C000010000000010000C0000000000100101001C00000100000C1
1000000C0CC00011001000100000010CC00C01010000C0010C0C011C000000010001
11000C01000001010C00100C00000C00101000000C00000000C0001C0000C0000011
1000000000000CC0001000C0000010000000000C1CC000000000000101001C011C11
1C1C0C01C000C100000CC000C01000100CCC0C000100100C00C000C00C0000001001
111C10110100C00CC0000000101000C1C000000CC0000000100000C0000000000001
1000000CC00C0011C01000001CC0000C1010CCC00000000000C000000000100010C1
100C0C0C100C0000000C1000C000000C001010C000C000C001101C00001C10000001
11000101011000000C00001C000000C00001C0010000000000000C00100100000101
100000000C10000000001000000000000100000C00CC000000101000C00100001101
1000C1000000000000001101000000010000C00010010C00C000010000000000C0C1
100C0010000C000000011011000100010000010010CC00100C0000C010C000C00001
10000000C10000010001010000101100100C1010000C1C0011001C000000101C1101
11000000C00000000C001000000C000001000C0000C0000000000011010000100001
100000010000C000100011C000011C000C000C00010001000C0100C0C0001000C101
1C00C00C000C00100000C01C00C00010000C00C10000010000010000000000000001
10C01C00C0101100000000000CC100000001000C0000C01C010C00C0000010000101
10000000C00001000001000C01C0010000C100C0011000C00000000010100010C101
100000001000C00000101000000C0C10C0C00000CC0C1001110000C0001000000011
10C01000000C0110101C0C00100000C0000010100001C0C10000000000CC000C0001
10000C10000000000000C001001C00C00C00110C0011101010C00010C0C000000001
11C001C000100110000000000000100C01010000000C10C0C1C0CCC11000C0000001
10100C0100000000000C01C1C00000000000C000100CC01011100CCC00C000001101
1001001000CCC001010001C000CC0001100C0000000000000000C10101010CC00C01
10001101C001C00001100C010100000000C110000C000000000100000110C0001001
11111111111111111111111111111111111111111111111111111111111111111111
