11111111111111111111111
10000000000000000000001
100CCCCC00000C111110001
10CC111CC0000C000001001
10CC00PCC0000C000000101
10CC000000000C000000101
100CCCCC00000C0000E0101
1000000CC0000C000000101
10CC000CC0000C000000101
10CC111CC0000C000001001
100CCCCC00000C111110001
10000000000000000000001
11111111111111111111111