11111111111111111
10010010P01001001
10010010C01001001
10010010C01001001
10010010C01001001
1001001CCC1001001
1001001CEC1001001
11111111111111111
