1111111111111111111111111111111111111111111111111111111111111111111111111111111
100100001000E1P0C00000C01010C00000000000010000110000C1000000C00001C000000000001
1C000C0CCC000100000C000C000C0011C0C01C1000001000000CC00000010100C0000000CCC0001
1C0000100000000000C0C0000000C1C000010011001000000C0000CC000000010000000C0100001
100000C0101110110001000C01001000C01C00000000000100100C00C0C00001000C10000000001
1001000000C00100000000C0C0C01C0C00000000C010C000C000010100000000000001C00000001
10101000000100000000001001000C11000C0000C00000000100C000C000000000C000001000001
10000000C00000011000C0CC0C000C00C010001000CC000000C0000000000000CC0000C00010001
1C01C0100C000000C00000100C01C0000000C110000011000000C100010000101000C00C0001001
10C000C000100000000000001001000000C001C1000000100001C0C01000CC000011000000C0001
10C0001100C00000000C000100C00000001C0001C1010000C0001C00000C1000C0CC10000100001
1010000C00C00110110000C10000C110C0000C00C11000000C00C1001000000000C0000100C0C01
1100010010C01C00100000C00000000000000000C0C000000010C00000C00000000CCC1011010C1
1010110C11000000001C0010010C0001C0C000C000000000C1001000C00000001000010CC001C01
1000000CC000C00C000C00000001C001C0010C001C00010000011000101001C0000000000C00101
100C010000000010011100CC000C0000C01000C0000C00C000C010000100110000C00CC0C000C01
1C000000000010100000000001C000110000000C00C00C00C0000000C000000001010000C00C001
10000100010C01010C00101CCC00C0C00001C110001C0CC0100000000C0C0101C10000010000011
1C1C10000000100000C001C00000000CC0000C001000C1C0000000000000C0000C000C000000011
10CC1C000C00000C00C011000100000001000000010110C00C0C00000000C0C0000100C100C0001
10C000001000C0100100C0000C000100CC01001000000C1000110100000C00C0000C0000C011101
1C00C00000000CC0C000000000C0C0CC100110000000C00000000000C00001000C010001C001001
10101CC0C00000C0110000000C01000C0000C00001100C00000C1000010000000010000C0000001
10000000100000000000010100100C0000C0100010010100010C000C0000000000C01C0000C0011
10000C0001101CC000000000010000000000000100100000100100000000001C0C0000000000001
100C0100C0000000000000CC000011CC0C0CC1C010000C00000C0000000C1010011000000000001
100000010000C0000000C00010C110001C0100100110100C0000000000C00000CC00000000C0001
100000010C000C0000000000C000000000C10000C000C00001000C00110100100000001C000C011
10000000C0C00000000000001010100000000001C0000C000101001000C00001000000C000010C1
1000100000C001000001000000000001CC000000000000001C00C000101C000C001CC0C00000001
1100001C01000000C0000C000001000001000000100C01C00C1001010000010C0000000C01C0001
1C010C000C0000C100000010000CC00000000C100000000000C0000C000000C1000000110010C01
11C001C0011000000C000000000010000001000000100000000010000101C1000000010C0101C01
100000000001001000000010C0C000100000000000000000101000000C00C0C00001CC000000001
1C0000000C0CC0000100000000010000000C00000C10101000011C00C0100000000000000C00011
10100000C000001110C0C01000000C01000C0010001001000001000C0C000C10000C00001000011
1100C000100C0000C000000C0000100C0000000000010C0C000010CC00000000C01000010CC0001
110000CC1000000000000001001011000100CC000C00C11000C000000C00C0C0000C1000C001001
1C0C0000C0C00000000000CC00C0C0000001000C00000C0000100000C00000000010C1C00001011
110C00000CC000000C1000000000C0C000C000000C0000C000C0001100C01C0CC000C000C000001
10000000000C0C0010000000C100100000C0000C000000C0110100C0C0000000000100010000001
100000010100000C0000001100000010C001010001C0C0010000C0C0C01CC100000000000000101
1010CC001000000100C000000000000CC0C00C00CC000100000CC010C0100000C0000C000100C01
100001C00000100CC00C01CC00CC11000C0C10C00C0100C00100001000CC0100100010000000001
100000000C00C010C10000001CC00000C0010000000010000C0100011010C100C0000000C0CCC01
10C0000C0000C00000100000010C000C0C000000CC0000100011000001100010000000010000001
10CCC0C001000100000C1000000000C1000000C0C00000C000000000000C000C1C0001CC0000101
10C000011C01000001000C10000C0000C0000C00000000010C00000C0C000C0C11C000001010C01
1CC000000C1011010C00C00110001010C00CC000000001CC00C00000000000C0000C00C00000C01
11010000000100C00100000000C00CC01000000000000010010000001C00C000100C001000C0001
1100C0010C0010100001C0C001100C00010000C00C00000C10CCC011C00101000000100001000C1
10C00000000001000000100000C000000000C00000000000000010000000000000000C01010C001
1111111111111111111111111111111111111111111111111111111111111111111111111111111
