11111111
10000011
10P00001
1000C0E1
11101001
11000C01
1C100C01
10C01101
11111111
