1111111111111111
10E10000CC0C0101
1P1011000C101011
10000100CC00C001
1C01000000000101
1000CC0CC0C10001
10C00C00CC00C001
1C0001C0C0000001
10C1010000C11011
1000000000C00001
1111111111111111
