1111111111
1000CEC001
10P0000001
1000010001
1C000CC001
100C000C01
1000000C11
1000C0C001
111C0000C1
10C0110001
1111111111
