1111111111111111
10PC010E00000C01
1C0C100000100C01
1100000000000001
1010000101C1C001
1000CC1001000101
1100001010001001
1000C10001100001
11000000C0C00001
1111111111111111
