111111111
1000E0001
1P000C0C1
100010001
100010101
1C0000CC1
111111111
