111111111111111111111111111
10CCP0000E010000000C0100001
100000C0101110110001000C011
1001000C01C0000000000010011
100C00C0C00001000C100000001
100001000000C00100000000C01
1C0C01C0C00000000C010C000C1
1000010100000000000001C0001
100000101000000100000000001
111111111111111111111111111
