1111111111111111111111111111111111111111111111111111111
1E1P101000001C00000C0C00CC01001101C00CC0100001000000001
11010000C100C0000000C00000C0C000C1C00000010C10CC01010C1
100000CC10011000000000000000CC0C01C1C01100010CC000100C1
11010001001000001C0C001C0C0000110CC100C000110C0000C0011
11C000C0100C00C0001100C0C0010C0C010CC0100CCC0C000000001
10CCCC111C0010010C100C10C0C00C01C00001001C01CC011000101
1CC000000C1CCC000010C10C001000C010100CCC000000CC0CCCC01
10100110C0C00C0010C101001010000000000010C1000010010C011
11C10CC00010C101C00000C000010C011010C110C0C100C11C00011
1111111111111111111111111111111111111111111111111111111
