111111111111111111111111
10P10001E00000C0C000C011
101000000000000000000001
1000100000CC0000CC000C01
1000100100C010010000C101
111111111111111111111111
