111111111
100E10C01
111010PC1
100010001
10100CC01
100010C11
100000C01
111111111
