1111111111111111111111111111
101000100001000E1P0C00000C01
11010C0000000000001000011001
100C1000000C00001C0000000001
100C000C0CCC000100000C000C01
100C0011C0C01C10000010000001
1CC00000010100C0000000CCC001
10C0000100000000000C0C000001
100C1C000010011001000000C001
1111111111111111111111111111
