11111111111111111
10100PC00000100E1
10000000000001011
100000010C00010C1
101000100010000C1
1101001C0C0000001
10000000C00C00001
1000C000010CCC111
10000000000000011
100000000000CC001
10001000000001001
100010CCC00000001
1C10C010000000001
100C0C00000100001
100100000001CC001
100000000C1000001
1000100000100C0C1
11000000110000001
100001000CCC00001
10C010000C0000011
100001000000C0C01
1C000000010000001
100001100000C0101
1000C00000001C0C1
10000010CC0C00101
10C00001C10000001
1000C0CC000010011
101001100000C00C1
10000C0000C000101
10000CCCCC00C0001
10C0C0000C0010001
11000C0000C1010C1
10C000000100C0011
10100110011000001
1C011100001010001
10100010110010001
10C0CC00000000001
11C00C000001100C1
1010CCC011C000001
110C10000C0C0C001
100C0C10000C00011
10111110C00101001
1C100C00000000001
10C010000C000C001
10100C01101010CC1
11C01000000011101
10000001000C00111
1C000001000001001
10C00000001110001
100C0CC000000C001
1000000000000C0C1
1000100000001C001
1000000000000C001
10000C10C0C0C1001
1C000000000101001
1000100CCC00C1001
100C11C100C00C101
100000000C0001001
11111111111111111
